1111111111111111
1E0010C001111111
100011100000CCE1
1P00001001111111
1001101000000111
100C100000110CC1
1111111111111111
